10
.##...###.
.#####....
...####.##
.##...###.
.##...###.
.##...###.
.##...###.
.##...###.
.##...###.
.......G..